###########################
#...c...#.........#...c...#
#.#####.#.###.###.#.#####.#
#.#...#.#.#.....#.#.#...#.#
#.#.#.#...#.###.#...#.#.#.#
#.#.#.#.#.#.ccc.#.#.#.#.#.#
#.#.#.#.#.#######.#.#.#.#.#
#...#.c.#....#....#.c.#...#
#.##########.#.##########.#
#..c.......#.#.#.......c..#
######.###.#c#c#.###.######
#..c.#...#.#.#.#.#...#.c..#
#.##.#.#.#.#.#.#.#.#.#.##.#
#......#.#...#...#.#......#
#.######.#########.######.#
#........#...#...#........#
####.#####.#.#.#.#####.####
#c......c..#...#..c......c#
#############X#############
