###################
#.....#.....#.....#
X.....#.c.c.#.....X
#...c.#.....#.c...#
#.....#.#.#.#.....#
#.......#c#.......#
#.#######.#######.#
#.......#c#.......#
#.....#.#.#.#.....#
#..c..#.....#..c..#
#.....#..c..#.....#
#.....#.....#.....#
###X###########X###
